순위,팀명,G,SBA,SB,CS,SB%,OOB,PKO
1,NC,118,208,156,52,75.0,36,11
2,두산,123,157,119,38,75.8,49,7
3,LG,123,155,112,43,72.3,44,7
4,SSG,121,147,111,36,75.5,35,3
5,한화,122,127,94,33,74.0,40,15
6,삼성,123,111,85,26,76.6,45,3
7,롯데,125,106,81,25,76.4,48,2
8,키움,125,81,69,12,85.2,31,5
9,KIA,120,84,67,17,79.8,40,6
10,KT,124,65,45,20,69.2,33,8
합계,,612,1241,939,302,75.7,401,67
